They've taken your arm. They said they'd do it if - when - you left, said it in the contract. It had all seemed perfectly sensible at the time; if you were going to survive on their warehouse floor, you needed to keep up with the loading mechs, and that meant replacing your last 'ganic arm with some industrial chrome. And since you didn't have the chips, well, they'd buy it for you - with a hitch: they'd take it back if you left before you'd done enough work to pay it off. And that's if they let you go before then at all. So you'd let them chop your arm off and jack you in, and felt grateful. Now, not so much. Now, all that perfectly rational explanation makes you sick. Doesn't do shit for the sense of absence on your left side, the dislocation that poisons you every time you try to use what isn't there anymore.

It wasn't like you'd have chosen to leave, given that choice. It was good work, for what it was. You'd show up every morning at 0700 below the warehouses's brutalist square concrete walls and take the rickety freight elevator to the tenth floor squeezed between mechs and cargo boxes. You'd push your way out of the elevator squeezing your noise cancelling 'buds in to find your loading team and start organizing the work for the day with the management AR-bot that ran the floor. It was loud, hot, uncomfortable, and often actively dangerous - more than once you'd barely evaded being maimed by falling crates or rushing mechs, and you'd seen more than a few of your buddies initiate indenture contracts with the corp to pay off the loan for replacements - but it was work you could do.

The problem was that another orchestrator had had it in for you from day zero, and they'd been at the company far longer. Today, he'd finally gotten the best of you: had you framed for petty theft, actually, stealing low value company property. They'd promptly "repossessed" your bike for not returning something you'd never had in the first place and kicked you to the curb - but not before taking back that arm.

In a sense, you were lucky. It could've been far worse.

You'd walked back home after that, pushing through the crowded streets fast and rough to match the rush of your thoughts, railing at the unfairness. You'd think after so long in the city you would've gotten used to this kind of shit, but not for a minute. Not yet anyway. Maybe that's a good sign, a sign they haven't worn you down, broken you. Or maybe it's a sign that you're too inflexible, that one day, instead of bending under the weight, you'll just snap, jump from one of the buildings or go psycho... 

                             /press any key to continue/

>look
Street Outside Apartment 154

* * *

Circuitboard Streets and Electric Life
An Interactive Fiction by Alexis Purslane
Release 1 / Serial number 230312 / Inform 7 v10.1.2 / D

Now you're standing outside the mega-arcology that holds your tiny apartment along with several thousand others, wondering what to do next. Suddenly you feel completely lost. The comforting monotony of work for most of the day and mindless entertainment for the rest is gone. You've been cut free, and free in this world means dead, because this is a world where you need protection and income and nobody competes with the corps by themselves. The only lead you have now is Jamie "Nano" Rivest, a retired cracker who offered you a job awhile back.

Welcome to the City. We hope you enjoy your stay.

Megablock Sidewalk
Megablock M-3B looms to the east like a monument to the concept of urban density and decay, throwing its city block worth of bulk against the sky, blotting out the sun and leaving you in a deep, cold shadow. The air here is moist with the water evaporating from the gutters of the city and acrid with the smoke of passing cars. The megablock tower is encircled by a thin sidewalk, interrupted here and there by pipes plunging into the ground. Pedestrians clog the streets around you, rushing to or from work. To the west is a busy street, and across that, a row of shops. The sidewalk curves around the building to the north east and south east.

>look
Megablock Sidewalk
Megablock M-3B looms to the east like a monument to the concept of urban density and decay, throwing its city block worth of bulk against the sky, blotting out the sun and leaving you in a deep, cold shadow. The air here is moist with the water evaporating from the gutters of the city and acrid with the smoke of passing cars. The megablock tower is encircled by a thin sidewalk, interrupted here and there by pipes plunging into the ground. Pedestrians clog the streets around you, rushing to or from work. To the west is a busy street, and across that, a row of shops. The sidewalk curves around the building to the north east and south east.

As the early-morning rush to work dies off, the city sidewalks slowly begin to empty out. Soon, there is no one left.

>look at pedestrians
You see pedestrians here.

* * *

>look
Megablock Sidewalk
Megablock M-3B looms to the east like a monument to the concept of urban density and decay, throwing its city block worth of bulk against the sky, blotting out the sun and leaving you in a deep, cold shadow. The air here is moist with the water evaporating from the gutters of the city and acrid with the smoke of passing cars. The megablock tower is encircled by a thin sidewalk, interrupted here and there by pipes plunging into the ground. Pedestrians clog the streets around you, rushing to or from work. To the west is a busy street, and across that, a row of shops. The sidewalk curves around the building to the north east and south east.

As the early-morning rush to work dies off, the city sidewalks slowly begin to empty out. Soon, there is no one left.

>w
You wait for a gap in the traffic, then dodge across the street as quickly as you can, shoes splashing in potholes as you pound across the asphalt.

Shop Fronts
You see a long line of shop fronts stretching away to the north and south here, an endless parade of neon advertisements thrown up like digital vomit across huge screens behind bullet proof glass shop windows. This shopping district, a whole city block in size just like the megablock, has quickly accreted here to take advantage of the density of customers brought about by the mega-arcology - and their bleak depression, which can only be salved by the dopamine hit of a new acquisition. The ads are gaudy, kitsch crocks, mostly, shit that barely has a purpose and barely works for that purpose. To the west you can see a wide but shallow flight of stairs leading under an archway between two nearby buildings and into the center of the shopping district.

Someone pushes past you, grunting an incomprehensible word which might be an apology or just as easily an insult.

As the early-morning rush to work dies off, the city sidewalks slowly begin to empty out. Soon, there is no one left.

>e
You wait for a gap in the traffic, then dodge across the street as quickly as you can, shoes splashing in potholes as you pound across the asphalt.

Megablock Sidewalk
Megablock M-3B looms to the east like a monument to the concept of urban density and decay, throwing its city block worth of bulk against the sky, blotting out the sun and leaving you in a deep, cold shadow. The air here is moist with the water evaporating from the gutters of the city and acrid with the smoke of passing cars. The megablock tower is encircled by a thin sidewalk, interrupted here and there by pipes plunging into the ground. Pedestrians clog the streets around you, rushing to or from work. To the west is a busy street, and across that, a row of shops. The sidewalk curves around the building to the north east and south east.

As the early-morning rush to work dies off, the city sidewalks slowly begin to empty out. Soon, there is no one left.

>w
You wait for a gap in the traffic, then dodge across the street as quickly as you can, shoes splashing in potholes as you pound across the asphalt.

Shop Fronts
You see a long line of shop fronts stretching away to the north and south here, an endless parade of neon advertisements thrown up like digital vomit across huge screens behind bullet proof glass shop windows. This shopping district, a whole city block in size just like the megablock, has quickly accreted here to take advantage of the density of customers brought about by the mega-arcology - and their bleak depression, which can only be salved by the dopamine hit of a new acquisition. The ads are gaudy, kitsch crocks, mostly, shit that barely has a purpose and barely works for that purpose. To the west you can see a wide but shallow flight of stairs leading under an archway between two nearby buildings and into the center of the shopping district.

Cars drive past with the low ripping sound of tires on asphalt, throwing up streams of dirty water that didn't quite make it into the sewer system - or didn't quite stay there - behind them. The sound of car horns and engines soaks every cubic millimeter of the air, deafening if you're not used to it.

As the early-morning rush to work dies off, the city sidewalks slowly begin to empty out. Soon, there is no one left.

>e
You wait for a gap in the traffic, then dodge across the street as quickly as you can, shoes splashing in potholes as you pound across the asphalt.

Megablock Sidewalk
Megablock M-3B looms to the east like a monument to the concept of urban density and decay, throwing its city block worth of bulk against the sky, blotting out the sun and leaving you in a deep, cold shadow. The air here is moist with the water evaporating from the gutters of the city and acrid with the smoke of passing cars. The megablock tower is encircled by a thin sidewalk, interrupted here and there by pipes plunging into the ground. Pedestrians clog the streets around you, rushing to or from work. To the west is a busy street, and across that, a row of shops. The sidewalk curves around the building to the north east and south east.

As the early-morning rush to work dies off, the city sidewalks slowly begin to empty out. Soon, there is no one left.

* * *

>look up
The sun filters down through a sky filled so fully with acrid pollutants that it is tinted a dingy green. Here and there, streamers of smoke or steam trail upward to add to the pervasive miasma.

>look at the sky
The sun filters down through a sky filled so fully with acrid pollutants that it is tinted a dingy green.

* * *

>look up
The sun filters down through a sky filled so fully with acrid pollutants that it is tinted a dingy green. Here and there, streamers of smoke or steam trail upward to add to the pervasive miasma.

>look east
You can't see anything promising that way.

* * *

>look at the pedestrians
You see pedestrians here.

* * *

>look east
The Megablock blocks out the entirety of the horizon in that direction, making you feel simultaneously overawed with airy scale and trapped.

* * *

>look west
You see a long line of shop fronts stretching away to the north and south across the street in that direction, an endless parade of neon advertisements thrown up like digital vomit across huge screens behind bullet proof glass shop windows. The shopping district those shop fronts belong to has quickly accreted here to take advantage of the density of customers brought about by the mega-arcology - and their bleak depression, which can only be salved by the dopamine hit of a new acquisition. The ads are gaudy, kitsch crocks, mostly, shit that barely has a purpose and barely works for that purpose.

* * *

I beg your pardon?

>wait
Time passes.

>wait
Time passes.

>wait 10
I only understood you as far as wanting to wait.

>wait
Time passes.

* * *

>wait
Time passes.

I beg your pardon?

* * *

>wait
Time passes.

>looik east
That's not a verb I recognise.

>look east
The Megablock blocks out the entirety of the horizon in that direction, making you feel simultaneously overawed with the airy scale of the thing and trapped.

>look west
You see a long line of shop fronts stretching away to the north and south across the street in that direction, an endless parade of neon advertisements thrown up like digital vomit across huge screens behind bullet proof glass shop windows. The shopping district those shop fronts belong to has quickly accreted here to take advantage of the density of customers brought about by the mega-arcology - and their bleak depression, which can only be salved by the dopamine hit of a new acquisition. The ads are gaudy, kitsch crocks, mostly, shit that barely has a purpose and barely works for that purpose.

>look north
You can't see anything special that way.

* * *

>look north
You can't see anything special the north.

* * *

>lok north
That's not a verb I recognise.

>look north
You can't see anything special north.

Cars drive past with the low ripping sound of tires on asphalt, throwing up streams of dirty water that didn't quite make it into the sewer system - or didn't quite stay there - behind them. The sound of car horns and engines soaks every cubic millimeter of the air, deafening if you're not used to it.

>look at pedestrians
You see pedestrians here.

* * *

>x pipes
That noun did not make sense in this context.

>x pedestrians
The pedestrians here in the Mulanosonic District are basically like the pedestrians in any other place, except poorer and more downtrodden. Instead of the stylish body-mods and upware you might see in other districts, typically all wrapped up in artificially fit bodies and stylish, tight-fitting clothing, what you see here is an endless parade of grimy, unhealthy people with utilitarian cyberware intended to serve a single function - work - and usually worse than what they gave up to get it for anything else. That's the kind of crowed the mega-arcologies are for, after all - the people that can't afford the luxury of a regular apartment, let alone an actual house, in this new reality of extreme urban density. There are benefits to such density, especially in places like Mulanosonic, because it means you don't need to pay for a car, transportation, or a (new) motorcycle, but those benefits aren't attracting anyone here. Anyone with a choice is elsewhere.

Cars drive past with the low ripping sound of tires on asphalt, throwing up streams of dirty water that didn't quite make it into the sewer system - or didn't quite stay there - behind them. The sound of car horns and engines soaks every cubic millimeter of the air, deafening if you're not used to it.
Someone pushes past you, grunting an incomprehensible word which might be an apology or just as easily an insult.

I beg your pardon?

>look east
The Megablock blocks out the entirety of the horizon in that direction, making you feel simultaneously overawed with the airy scale of the thing and trapped.

* * *

>w
You can't go that way.

>n
You can't go that way.

>look up
The sun filters down through a sky filled so fully with acrid pollutants that it is tinted a dingy green. Here and there, streamers of smoke or steam trail upward to add to the pervasive miasma.

* * *

>x megablock
The tower is rectangular in cross section and in profile, covered in rows of plumbing and ventilation pipes. It is made of crumbling concrete painted in a dismal, chipping sky-blue, as if in an attempt to make the building a replacement for the sky itself, occasionally crisscrossed by rusting steel girders framing the concrete slab sides. There are a few slits here and there in the concrete, short windows every storey of the several hundred storeys that make up the building.

Someone pushes past you, grunting an incomprehensible word which might be an apology or just as easily an insult.

* * *

>x pedestrians
The pedestrians here in the Mulanosonic District are basically like the pedestrians in any other place, except poorer and more downtrodden. Instead of the stylish body-mods and upware you might see in other districts, typically all wrapped up in artificially fit bodies and stylish, tight-fitting clothing, what you see here is an endless parade of grimy, unhealthy people with utilitarian cyberware intended to serve a single function - work - and nothing else, rushing back and forth with their sunken eyes downcast and their chins buried in their coats. This is, after all, the target customer base of the mega-arcologies: those too poor to afford housing anywhere else in the dense urban sprawl of the city. There are a few meagre benefits, but no one lives here by choice. Not even you.

>x tower
The tower is rectangular in cross section and in profile, covered in rows of plumbing and ventilation pipes. It is made of crumbling concrete painted in a dismal, chipping sky-blue, as if in an attempt to make the building a replacement for the sky itself, occasionally crisscrossed by rusting steel girders framing the concrete slab sides. There are a few slits here and there in the concrete, short windows every storey of the several hundred storeys that make up the building.

* * *

>x pedestrians
That noun did not make sense in this context.

>look at pedestrians
You can't see any such thing.

* * *

>look at pedestrians
You can't see any such thing.

>nouns
At the moment, "it" is unset, "him" is unset, "her" is unset and "them" is unset.

>objects
That's not a verb I recognise.

>backdrops
That's not a verb I recognise.

>scenery
That's not a verb I recognise.

>list
That's not a verb I recognise.

>list scenery
That's not a verb I recognise.

* * *

>w
You wait for a gap in the traffic, then dodge across the street as quickly as you can, shoes splashing in potholes as you pound across the asphalt.

Shop Fronts
You see a long line of shop fronts stretching away to the north and south here, an endless parade of neon advertisements thrown up like digital vomit across huge screens behind bullet proof glass shop windows. This shopping district, a whole city block in size just like the megablock, has quickly accreted here to take advantage of the density of customers brought about by the mega-arcology - and their bleak depression, which can only be salved by the dopamine hit of a new acquisition. The ads are gaudy, kitsch crocks, mostly, shit that barely has a purpose and barely works for that purpose. To the west you can see a wide but shallow flight of stairs leading under an archway between two nearby buildings and into the center of the shopping district.

>e
You glance both ways, then run across the street.

Megablock Sidewalk
Megablock M-3B looms to the east like a monument to the concept of urban density and decay, throwing its city block worth of bulk against the sky, blotting out the sun and leaving you in a deep, cold shadow. The air here is moist with the water evaporating from the gutters of the city and acrid with the smoke of passing cars. The megablock tower is encircled by a thin sidewalk, interrupted here and there by pipes plunging into the ground. A few needles and articles of ragged clothing lie about the sidewalk, and pieces of waste gust about on the wind like leaves. To the west is a busy street, and across that, a row of shops. The sidewalk curves around the building to the north east and south east.

>w
You glance both ways, then run across the street.

Shop Fronts
You see a long line of shop fronts stretching away to the north and south here, an endless parade of neon advertisements thrown up like digital vomit across huge screens behind bullet proof glass shop windows. This shopping district, a whole city block in size just like the megablock, has quickly accreted here to take advantage of the density of customers brought about by the mega-arcology - and their bleak depression, which can only be salved by the dopamine hit of a new acquisition. The ads are gaudy, kitsch crocks, mostly, shit that barely has a purpose and barely works for that purpose. To the west you can see a wide but shallow flight of stairs leading under an archway between two nearby buildings and into the center of the shopping district.

>e
Megablock Sidewalk
Megablock M-3B looms to the east like a monument to the concept of urban density and decay, throwing its city block worth of bulk against the sky, blotting out the sun and leaving you in a deep, cold shadow. The air here is moist with the water evaporating from the gutters of the city and acrid with the smoke of passing cars. The megablock tower is encircled by a thin sidewalk, interrupted here and there by pipes plunging into the ground. A few needles and articles of ragged clothing lie about the sidewalk, and pieces of waste gust about on the wind like leaves. To the west is a busy street, and across that, a row of shops. The sidewalk curves around the building to the north east and south east.

>w
You look both ways warily, then cross the street.

Shop Fronts
You see a long line of shop fronts stretching away to the north and south here, an endless parade of neon advertisements thrown up like digital vomit across huge screens behind bullet proof glass shop windows. This shopping district, a whole city block in size just like the megablock, has quickly accreted here to take advantage of the density of customers brought about by the mega-arcology - and their bleak depression, which can only be salved by the dopamine hit of a new acquisition. The ads are gaudy, kitsch crocks, mostly, shit that barely has a purpose and barely works for that purpose. To the west you can see a wide but shallow flight of stairs leading under an archway between two nearby buildings and into the center of the shopping district.

I beg your pardon?

>w
You can't go that way.

>w
You can't go that way.

>e
Megablock Sidewalk
Megablock M-3B looms to the east like a monument to the concept of urban density and decay, throwing its city block worth of bulk against the sky, blotting out the sun and leaving you in a deep, cold shadow. The air here is moist with the water evaporating from the gutters of the city and acrid with the smoke of passing cars. The megablock tower is encircled by a thin sidewalk, interrupted here and there by pipes plunging into the ground. A few needles and articles of ragged clothing lie about the sidewalk, and pieces of waste gust about on the wind like leaves. To the west is a busy street, and across that, a row of shops. The sidewalk curves around the building to the north east and south east.

* * *

>e
Megablock Sidewalk
Megablock M-3B looms to the east like a monument to the concept of urban density and decay, throwing its city block worth of bulk against the sky, blotting out the sun and leaving you in a deep, cold shadow. The air here is moist with the water evaporating from the gutters of the city and acrid with the smoke of passing cars. The megablock tower is encircled by a thin sidewalk, interrupted here and there by pipes plunging into the ground. A few needles and articles of ragged clothing lie about the sidewalk, and pieces of waste gust about on the wind like leaves. To the west is a busy street, and across that, a row of shops. The sidewalk curves around the building to the north east and south east.

* * *

>time
That's not a verb I recognize.

>what time is it
That's not a verb I recognize.

* * *

>look at the megablock
The tower is rectangular in cross section and in profile, covered in rows of plumbing and ventilation pipes. It is made of crumbling concrete painted in a dismal, chipping sky-blue, as if in an attempt to make the building a replacement for the sky itself. Sheer concrete cliff faces are occasionally crisscrossed by rusting steel girders which have the visual effect more of window frames than structural supports. There are a few slits here and there in the concrete, short windows every storey of the several hundred storeys that make up the building.

* * *

>e
You can't go that way.

>w
Shop Fronts
You see a long line of shop fronts stretching away to the north and south here, an endless parade of neon advertisements thrown up like digital vomit across huge screens behind bullet proof glass shop windows. This shopping district, a whole city block in size just like the megablock, has quickly accreted here to take advantage of the density of customers brought about by the mega-arcology - and their bleak depression, which can only be salved by the dopamine hit of a new acquisition. The ads are gaudy, kitsch crocks, mostly, shit that barely has a purpose and barely works for that purpose. To the west you can see a wide but shallow flight of stairs leading under an archway between two nearby buildings and into the center of the shopping district.

>e
Megablock Sidewalk
Megablock M-3B looms to the east like a monument to the concept of urban density and decay, throwing its city block worth of bulk against the sky, blotting out the sun and leaving you in a deep, cold shadow. The air here is moist with the water evaporating from the gutters of the city and acrid with the smoke of passing cars. The megablock tower is encircled by a thin sidewalk, interrupted here and there by pipes plunging into the ground. A few needles and articles of ragged clothing lie about the sidewalk, and pieces of waste gust about on the wind like leaves. To the west is a busy street, and across that, a row of shops. The sidewalk curves around the building to the north east and south east.

* * *

>\r
Circuitboard Streets and Electric Life
An Interactive Fiction by Alexis Purslane
Release 1 / Serial number 230310 / Inform 7 v10.1.2 / D

Now you're standing outside the mega-arcology that holds your tiny apartment along with several thousand others, wondering what to do next. Suddenly you feel completely lost. The comforting monotony of work for most of the day and mindless entertainment for the rest is gone. You've been cut free, and free in this world means dead, because this is a world where you need protection and income and nobody competes with the corps by themselves. The only lead you have now is Jamie "Nano" Rivest, a retired cracker who offered you a job awhile back.

Welcome to the City. We hope you enjoy your stay.

Outside Megablock M-3B
Megablock M-3B looms to the east like a monument to the concept of urban density and decay, throwing its city block worth of bulk against the sky, blotting out the sun and leaving you in a deep, cold shadow. The air here is moist with the water evaporating from the gutters of the city and acrid with the smoke of passing cars. The megablock tower is encircled by a thin sidewalk, interrupted here and there by pipes plunging into the ground. Pedestrians clog the streets around you, rushing to or from work. To the west is a busy street, and across that, a row of shops. The sidewalk curves around the building to the north and south east.

>x pedestrians
That noun did not make sense in this context.